############################
#------------##------------#
#-####-#####-##-#####-####-#
#!####-#####-##-#####-####!#
#-####-#####-##-#####-####-#
#--------------------------#
#-####-##-########-##-####-#
#-####-##-########-##-####-#
#------##----##----##------#
######-##### ## #####-######
######-##### ## #####-######
######-##          ##-######
######-## @@@@@@@@ ##-######
######-## @@@@@@@@ ##-######
1     -   @@@@@@@@   -     1
######-## @@@@@@@@ ##-######
######-## @@@@@@@@ ##-######
######-##          ##-######
######-## ######## ##-######
######-## ######## ##-######
#------------##------------#
#-####-#####-##-#####-####-#
#-####-#####-##-#####-####-#
#!--##-------$$-------##--!#
###-##-##-########-##-##-###
###-##-##-########-##-##-###
#------##----##----##------#
#-##########-##-##########-#
#-##########-##-##########-#
#--------------------------#
############################
